Id,Id2,Geography,Total:,Urban:,Urban: - Inside urbanized areas,Urban: - Inside urban clusters,Rural,Not defined for this file
8600000US53001,53001,ZCTA5 53001,1901,0,0,0,1901,0
8600000US53002,53002,ZCTA5 53002,2299,0,0,0,2299,0
8600000US53003,53003,ZCTA5 53003,141,0,0,0,141,0
8600000US53004,53004,ZCTA5 53004,3330,0,0,0,3330,0
8600000US53005,53005,ZCTA5 53005,19425,19425,19425,0,0,0
8600000US53006,53006,ZCTA5 53006,1779,0,0,0,1779,0
8600000US53007,53007,ZCTA5 53007,1841,1841,1841,0,0,0
8600000US53010,53010,ZCTA5 53010,7681,0,0,0,7681,0
8600000US53011,53011,ZCTA5 53011,2260,0,0,0,2260,0
8600000US53012,53012,ZCTA5 53012,18097,13067,13067,0,5030,0
8600000US53013,53013,ZCTA5 53013,3308,0,0,0,3308,0
8600000US53014,53014,ZCTA5 53014,7962,3590,0,3590,4372,0
8600000US53015,53015,ZCTA5 53015,2609,0,0,0,2609,0
8600000US53016,53016,ZCTA5 53016,384,0,0,0,384,0
8600000US53017,53017,ZCTA5 53017,5538,2919,2919,0,2619,0
8600000US53018,53018,ZCTA5 53018,7899,6148,6148,0,1751,0
8600000US53019,53019,ZCTA5 53019,2027,892,892,0,1135,0
8600000US53020,53020,ZCTA5 53020,3500,0,0,0,3500,0
8600000US53021,53021,ZCTA5 53021,4709,0,0,0,4709,0
8600000US53022,53022,ZCTA5 53022,18920,17050,17050,0,1870,0
8600000US53023,53023,ZCTA5 53023,1496,0,0,0,1496,0
8600000US53024,53024,ZCTA5 53024,16579,13503,13503,0,3076,0
8600000US53027,53027,ZCTA5 53027,22041,14666,14666,0,7375,0
8600000US53029,53029,ZCTA5 53029,20799,18795,18795,0,2004,0
8600000US53031,53031,ZCTA5 53031,43,0,0,0,43,0
8600000US53032,53032,ZCTA5 53032,4757,3493,0,3493,1264,0
8600000US53033,53033,ZCTA5 53033,4885,3138,3138,0,1747,0
8600000US53034,53034,ZCTA5 53034,1811,0,0,0,1811,0
8600000US53035,53035,ZCTA5 53035,2406,0,0,0,2406,0
8600000US53036,53036,ZCTA5 53036,2720,950,950,0,1770,0
8600000US53037,53037,ZCTA5 53037,9260,7439,7439,0,1821,0
8600000US53038,53038,ZCTA5 53038,4013,2701,0,2701,1312,0
8600000US53039,53039,ZCTA5 53039,4863,2736,0,2736,2127,0
8600000US53040,53040,ZCTA5 53040,8064,4007,4007,0,4057,0
8600000US53042,53042,ZCTA5 53042,6690,3741,0,3741,2949,0
8600000US53044,53044,ZCTA5 53044,2297,2147,2147,0,150,0
8600000US53045,53045,ZCTA5 53045,21686,21515,21515,0,171,0
8600000US53046,53046,ZCTA5 53046,1107,924,924,0,183,0
8600000US53047,53047,ZCTA5 53047,78,0,0,0,78,0
8600000US53048,53048,ZCTA5 53048,3364,0,0,0,3364,0
8600000US53049,53049,ZCTA5 53049,2451,305,305,0,2146,0
8600000US53050,53050,ZCTA5 53050,6986,5134,0,5134,1852,0
8600000US53051,53051,ZCTA5 53051,35651,33459,33459,0,2192,0
8600000US53057,53057,ZCTA5 53057,1928,0,0,0,1928,0
8600000US53058,53058,ZCTA5 53058,3243,2679,2679,0,564,0
8600000US53059,53059,ZCTA5 53059,1767,0,0,0,1767,0
8600000US53061,53061,ZCTA5 53061,5196,3171,0,3171,2025,0
8600000US53063,53063,ZCTA5 53063,1552,0,0,0,1552,0
8600000US53065,53065,ZCTA5 53065,2226,0,0,0,2226,0
8600000US53066,53066,ZCTA5 53066,33830,25176,25176,0,8654,0
8600000US53069,53069,ZCTA5 53069,697,697,697,0,0,0
8600000US53070,53070,ZCTA5 53070,4713,2724,0,2724,1989,0
8600000US53072,53072,ZCTA5 53072,23907,23224,23224,0,683,0
8600000US53073,53073,ZCTA5 53073,15757,8799,0,8799,6958,0
8600000US53074,53074,ZCTA5 53074,12880,11419,11419,0,1461,0
8600000US53075,53075,ZCTA5 53075,3345,0,0,0,3345,0
8600000US53076,53076,ZCTA5 53076,3648,676,676,0,2972,0
8600000US53078,53078,ZCTA5 53078,1912,0,0,0,1912,0
8600000US53079,53079,ZCTA5 53079,1413,0,0,0,1413,0
8600000US53080,53080,ZCTA5 53080,5715,4151,4151,0,1564,0
8600000US53081,53081,ZCTA5 53081,43129,42584,42584,0,545,0
8600000US53083,53083,ZCTA5 53083,20362,18841,18841,0,1521,0
8600000US53085,53085,ZCTA5 53085,11267,7741,7741,0,3526,0
8600000US53086,53086,ZCTA5 53086,8255,5858,5858,0,2397,0
8600000US53088,53088,ZCTA5 53088,379,0,0,0,379,0
8600000US53089,53089,ZCTA5 53089,18568,16769,16769,0,1799,0
8600000US53090,53090,ZCTA5 53090,21873,15779,15779,0,6094,0
8600000US53091,53091,ZCTA5 53091,2018,0,0,0,2018,0
8600000US53092,53092,ZCTA5 53092,20024,19467,19467,0,557,0
8600000US53093,53093,ZCTA5 53093,1981,0,0,0,1981,0
8600000US53094,53094,ZCTA5 53094,19169,15070,0,15070,4099,0
8600000US53095,53095,ZCTA5 53095,27139,20695,20695,0,6444,0
8600000US53097,53097,ZCTA5 53097,6319,3198,3198,0,3121,0
8600000US53098,53098,ZCTA5 53098,11965,8278,0,8278,3687,0
8600000US53103,53103,ZCTA5 53103,3724,2365,2365,0,1359,0
8600000US53104,53104,ZCTA5 53104,5426,1967,1967,0,3459,0
8600000US53105,53105,ZCTA5 53105,29225,16288,887,15401,12937,0
8600000US53108,53108,ZCTA5 53108,3329,433,433,0,2896,0
8600000US53110,53110,ZCTA5 53110,18320,18320,18320,0,0,0
8600000US53114,53114,ZCTA5 53114,2678,1552,0,1552,1126,0
8600000US53115,53115,ZCTA5 53115,15788,10647,0,10647,5141,0
8600000US53118,53118,ZCTA5 53118,7202,3058,3058,0,4144,0
8600000US53119,53119,ZCTA5 53119,5608,2790,0,2790,2818,0
8600000US53120,53120,ZCTA5 53120,9679,5479,0,5479,4200,0
8600000US53121,53121,ZCTA5 53121,19045,12484,0,12484,6561,0
8600000US53122,53122,ZCTA5 53122,5985,5985,5985,0,0,0
8600000US53125,53125,ZCTA5 53125,1895,1341,0,1341,554,0
8600000US53126,53126,ZCTA5 53126,6431,1529,1529,0,4902,0
8600000US53128,53128,ZCTA5 53128,8947,7587,7587,0,1360,0
8600000US53129,53129,ZCTA5 53129,13973,13973,13973,0,0,0
8600000US53130,53130,ZCTA5 53130,7755,7755,7755,0,0,0
8600000US53132,53132,ZCTA5 53132,34863,33334,33334,0,1529,0
8600000US53137,53137,ZCTA5 53137,1702,0,0,0,1702,0
8600000US53139,53139,ZCTA5 53139,2802,1066,0,1066,1736,0
8600000US53140,53140,ZCTA5 53140,30017,29753,29753,0,264,0
8600000US53142,53142,ZCTA5 53142,32375,31696,31696,0,679,0
8600000US53143,53143,ZCTA5 53143,23264,23264,23264,0,0,0
8600000US53144,53144,ZCTA5 53144,27256,24381,24381,0,2875,0
8600000US53146,53146,ZCTA5 53146,7458,5313,5313,0,2145,0
8600000US53147,53147,ZCTA5 53147,16457,12120,113,12007,4337,0
8600000US53149,53149,ZCTA5 53149,19057,14070,55,14015,4987,0
8600000US53150,53150,ZCTA5 53150,24850,23025,23025,0,1825,0
8600000US53151,53151,ZCTA5 53151,31987,31987,31987,0,0,0
8600000US53153,53153,ZCTA5 53153,2328,1941,0,1941,387,0
8600000US53154,53154,ZCTA5 53154,34451,34160,34160,0,291,0
8600000US53156,53156,ZCTA5 53156,2992,0,0,0,2992,0
8600000US53158,53158,ZCTA5 53158,15917,15006,15006,0,911,0
8600000US53167,53167,ZCTA5 53167,399,399,0,399,0,0
8600000US53168,53168,ZCTA5 53168,8643,6311,6311,0,2332,0
8600000US53170,53170,ZCTA5 53170,2380,2380,2380,0,0,0
8600000US53172,53172,ZCTA5 53172,21156,21156,21156,0,0,0
8600000US53177,53177,ZCTA5 53177,8329,6858,6858,0,1471,0
8600000US53178,53178,ZCTA5 53178,2626,0,0,0,2626,0
8600000US53179,53179,ZCTA5 53179,6310,4807,4807,0,1503,0
8600000US53181,53181,ZCTA5 53181,7357,6416,6416,0,941,0
8600000US53182,53182,ZCTA5 53182,9412,6335,428,5907,3077,0
8600000US53183,53183,ZCTA5 53183,2815,2638,2638,0,177,0
8600000US53184,53184,ZCTA5 53184,4271,3042,0,3042,1229,0
8600000US53185,53185,ZCTA5 53185,18551,15078,7344,7734,3473,0
8600000US53186,53186,ZCTA5 53186,33592,33592,33592,0,0,0
8600000US53188,53188,ZCTA5 53188,35195,33848,33848,0,1347,0
8600000US53189,53189,ZCTA5 53189,26228,20919,20583,336,5309,0
8600000US53190,53190,ZCTA5 53190,19200,14227,0,14227,4973,0
8600000US53191,53191,ZCTA5 53191,2842,2601,0,2601,241,0
8600000US53192,53192,ZCTA5 53192,217,113,113,0,104,0
8600000US53195,53195,ZCTA5 53195,114,0,0,0,114,0
8600000US53202,53202,ZCTA5 53202,23386,23386,23386,0,0,0
8600000US53203,53203,ZCTA5 53203,938,938,938,0,0,0
8600000US53204,53204,ZCTA5 53204,42355,42355,42355,0,0,0
8600000US53205,53205,ZCTA5 53205,10050,10050,10050,0,0,0
8600000US53206,53206,ZCTA5 53206,28210,28210,28210,0,0,0
8600000US53207,53207,ZCTA5 53207,35149,35149,35149,0,0,0
8600000US53208,53208,ZCTA5 53208,31133,31133,31133,0,0,0
8600000US53209,53209,ZCTA5 53209,46917,46917,46917,0,0,0
8600000US53210,53210,ZCTA5 53210,28126,28126,28126,0,0,0
8600000US53211,53211,ZCTA5 53211,35406,35406,35406,0,0,0
8600000US53212,53212,ZCTA5 53212,30416,30416,30416,0,0,0
8600000US53213,53213,ZCTA5 53213,26020,26020,26020,0,0,0
8600000US53214,53214,ZCTA5 53214,34725,34725,34725,0,0,0
8600000US53215,53215,ZCTA5 53215,60953,60953,60953,0,0,0
8600000US53216,53216,ZCTA5 53216,32264,32264,32264,0,0,0
8600000US53217,53217,ZCTA5 53217,29192,29192,29192,0,0,0
8600000US53218,53218,ZCTA5 53218,40625,40625,40625,0,0,0
8600000US53219,53219,ZCTA5 53219,33880,33880,33880,0,0,0
8600000US53220,53220,ZCTA5 53220,26303,26303,26303,0,0,0
8600000US53221,53221,ZCTA5 53221,37701,37701,37701,0,0,0
8600000US53222,53222,ZCTA5 53222,25165,25165,25165,0,0,0
8600000US53223,53223,ZCTA5 53223,29230,29230,29230,0,0,0
8600000US53224,53224,ZCTA5 53224,21284,21284,21284,0,0,0
8600000US53225,53225,ZCTA5 53225,25706,25706,25706,0,0,0
8600000US53226,53226,ZCTA5 53226,18370,18370,18370,0,0,0
8600000US53227,53227,ZCTA5 53227,23357,23357,23357,0,0,0
8600000US53228,53228,ZCTA5 53228,14369,14369,14369,0,0,0
8600000US53233,53233,ZCTA5 53233,16453,16453,16453,0,0,0
8600000US53235,53235,ZCTA5 53235,9270,9270,9270,0,0,0
8600000US53295,53295,ZCTA5 53295,359,359,359,0,0,0
8600000US53402,53402,ZCTA5 53402,33174,31625,31625,0,1549,0
8600000US53403,53403,ZCTA5 53403,27432,27294,27294,0,138,0
8600000US53404,53404,ZCTA5 53404,15658,15658,15658,0,0,0
8600000US53405,53405,ZCTA5 53405,25193,25193,25193,0,0,0
8600000US53406,53406,ZCTA5 53406,25845,25056,25056,0,789,0
8600000US53501,53501,ZCTA5 53501,23,0,0,0,23,0
8600000US53502,53502,ZCTA5 53502,2421,0,0,0,2421,0
8600000US53503,53503,ZCTA5 53503,1947,0,0,0,1947,0
8600000US53504,53504,ZCTA5 53504,2084,0,0,0,2084,0
8600000US53505,53505,ZCTA5 53505,354,0,0,0,354,0
8600000US53506,53506,ZCTA5 53506,1125,0,0,0,1125,0
8600000US53507,53507,ZCTA5 53507,2196,0,0,0,2196,0
8600000US53508,53508,ZCTA5 53508,5262,0,0,0,5262,0
8600000US53510,53510,ZCTA5 53510,1482,0,0,0,1482,0
8600000US53511,53511,ZCTA5 53511,48929,43775,43775,0,5154,0
8600000US53515,53515,ZCTA5 53515,2268,1269,0,1269,999,0
8600000US53516,53516,ZCTA5 53516,2152,0,0,0,2152,0
8600000US53517,53517,ZCTA5 53517,1752,0,0,0,1752,0
8600000US53518,53518,ZCTA5 53518,1330,0,0,0,1330,0
8600000US53520,53520,ZCTA5 53520,6810,3506,0,3506,3304,0
8600000US53521,53521,ZCTA5 53521,3656,1424,0,1424,2232,0
8600000US53522,53522,ZCTA5 53522,1085,0,0,0,1085,0
8600000US53523,53523,ZCTA5 53523,4949,2577,0,2577,2372,0
8600000US53525,53525,ZCTA5 53525,4052,0,0,0,4052,0
8600000US53526,53526,ZCTA5 53526,565,0,0,0,565,0
8600000US53527,53527,ZCTA5 53527,9963,6987,6987,0,2976,0
8600000US53528,53528,ZCTA5 53528,5734,3575,3575,0,2159,0
8600000US53529,53529,ZCTA5 53529,2031,0,0,0,2031,0
8600000US53530,53530,ZCTA5 53530,4566,0,0,0,4566,0
8600000US53531,53531,ZCTA5 53531,4338,0,0,0,4338,0
8600000US53532,53532,ZCTA5 53532,13606,10795,10795,0,2811,0
8600000US53533,53533,ZCTA5 53533,7276,4756,0,4756,2520,0
8600000US53534,53534,ZCTA5 53534,11512,7208,0,7208,4304,0
8600000US53536,53536,ZCTA5 53536,8503,5669,0,5669,2834,0
8600000US53537,53537,ZCTA5 53537,781,0,0,0,781,0
8600000US53538,53538,ZCTA5 53538,18468,13192,0,13192,5276,0
8600000US53540,53540,ZCTA5 53540,169,0,0,0,169,0
8600000US53541,53541,ZCTA5 53541,861,0,0,0,861,0
8600000US53543,53543,ZCTA5 53543,1641,0,0,0,1641,0
8600000US53544,53544,ZCTA5 53544,800,0,0,0,800,0
8600000US53545,53545,ZCTA5 53545,23117,21212,21212,0,1905,0
8600000US53546,53546,ZCTA5 53546,30648,27892,27892,0,2756,0
8600000US53548,53548,ZCTA5 53548,18558,15136,15136,0,3422,0
8600000US53549,53549,ZCTA5 53549,10414,7913,0,7913,2501,0
8600000US53550,53550,ZCTA5 53550,1239,0,0,0,1239,0
8600000US53551,53551,ZCTA5 53551,8273,6581,0,6581,1692,0
8600000US53553,53553,ZCTA5 53553,624,0,0,0,624,0
8600000US53554,53554,ZCTA5 53554,1134,0,0,0,1134,0
8600000US53555,53555,ZCTA5 53555,8465,3014,0,3014,5451,0
8600000US53556,53556,ZCTA5 53556,2594,0,0,0,2594,0
8600000US53557,53557,ZCTA5 53557,482,0,0,0,482,0
8600000US53558,53558,ZCTA5 53558,10742,9935,9935,0,807,0
8600000US53559,53559,ZCTA5 53559,6063,3834,0,3834,2229,0
8600000US53560,53560,ZCTA5 53560,3458,1687,0,1687,1771,0
8600000US53561,53561,ZCTA5 53561,1618,0,0,0,1618,0
8600000US53562,53562,ZCTA5 53562,23627,21718,21718,0,1909,0
8600000US53563,53563,ZCTA5 53563,10728,6766,6766,0,3962,0
8600000US53565,53565,ZCTA5 53565,4765,0,0,0,4765,0
8600000US53566,53566,ZCTA5 53566,15217,10883,0,10883,4334,0
8600000US53569,53569,ZCTA5 53569,1155,0,0,0,1155,0
8600000US53570,53570,ZCTA5 53570,2627,0,0,0,2627,0
8600000US53571,53571,ZCTA5 53571,280,0,0,0,280,0
8600000US53572,53572,ZCTA5 53572,9970,6997,0,6997,2973,0
8600000US53573,53573,ZCTA5 53573,3062,0,0,0,3062,0
8600000US53574,53574,ZCTA5 53574,3877,0,0,0,3877,0
8600000US53575,53575,ZCTA5 53575,15494,9635,0,9635,5859,0
8600000US53576,53576,ZCTA5 53576,2319,0,0,0,2319,0
8600000US53577,53577,ZCTA5 53577,1371,0,0,0,1371,0
8600000US53578,53578,ZCTA5 53578,5924,3972,0,3972,1952,0
8600000US53579,53579,ZCTA5 53579,1760,0,0,0,1760,0
8600000US53580,53580,ZCTA5 53580,564,0,0,0,564,0
8600000US53581,53581,ZCTA5 53581,10699,5021,0,5021,5678,0
8600000US53582,53582,ZCTA5 53582,1079,0,0,0,1079,0
8600000US53583,53583,ZCTA5 53583,5747,3761,0,3761,1986,0
8600000US53585,53585,ZCTA5 53585,2215,0,0,0,2215,0
8600000US53586,53586,ZCTA5 53586,2284,0,0,0,2284,0
8600000US53587,53587,ZCTA5 53587,1290,0,0,0,1290,0
8600000US53588,53588,ZCTA5 53588,4077,0,0,0,4077,0
8600000US53589,53589,ZCTA5 53589,19427,15521,15521,0,3906,0
8600000US53590,53590,ZCTA5 53590,36294,32721,32721,0,3573,0
8600000US53593,53593,ZCTA5 53593,19225,14872,14872,0,4353,0
8600000US53594,53594,ZCTA5 53594,5144,3059,0,3059,2085,0
8600000US53597,53597,ZCTA5 53597,16844,13713,13713,0,3131,0
8600000US53598,53598,ZCTA5 53598,2511,2043,2043,0,468,0
8600000US53599,53599,ZCTA5 53599,69,0,0,0,69,0
8600000US53702,53702,ZCTA5 53702,50,50,50,0,0,0
8600000US53703,53703,ZCTA5 53703,27958,27958,27958,0,0,0
8600000US53704,53704,ZCTA5 53704,44034,43785,43785,0,249,0
8600000US53705,53705,ZCTA5 53705,23494,23494,23494,0,0,0
8600000US53706,53706,ZCTA5 53706,5133,5133,5133,0,0,0
8600000US53711,53711,ZCTA5 53711,45728,43576,43576,0,2152,0
8600000US53713,53713,ZCTA5 53713,22146,22138,22138,0,8,0
8600000US53714,53714,ZCTA5 53714,16463,16463,16463,0,0,0
8600000US53715,53715,ZCTA5 53715,12136,12136,12136,0,0,0
8600000US53716,53716,ZCTA5 53716,18419,18419,18419,0,0,0
8600000US53717,53717,ZCTA5 53717,11962,11962,11962,0,0,0
8600000US53718,53718,ZCTA5 53718,11753,11078,11078,0,675,0
8600000US53719,53719,ZCTA5 53719,28487,28462,28462,0,25,0
8600000US53726,53726,ZCTA5 53726,5177,5177,5177,0,0,0
8600000US53792,53792,ZCTA5 53792,0,0,0,0,0,0
8600000US53801,53801,ZCTA5 53801,878,0,0,0,878,0
8600000US53802,53802,ZCTA5 53802,58,0,0,0,58,0
8600000US53803,53803,ZCTA5 53803,1306,0,0,0,1306,0
8600000US53804,53804,ZCTA5 53804,1372,0,0,0,1372,0
8600000US53805,53805,ZCTA5 53805,5269,3261,0,3261,2008,0
8600000US53806,53806,ZCTA5 53806,1831,0,0,0,1831,0
8600000US53807,53807,ZCTA5 53807,4843,0,0,0,4843,0
8600000US53808,53808,ZCTA5 53808,1049,0,0,0,1049,0
8600000US53809,53809,ZCTA5 53809,4120,0,0,0,4120,0
8600000US53810,53810,ZCTA5 53810,429,0,0,0,429,0
8600000US53811,53811,ZCTA5 53811,3371,0,0,0,3371,0
8600000US53813,53813,ZCTA5 53813,6075,3688,0,3688,2387,0
8600000US53816,53816,ZCTA5 53816,810,0,0,0,810,0
8600000US53817,53817,ZCTA5 53817,205,0,0,0,205,0
8600000US53818,53818,ZCTA5 53818,15091,11236,0,11236,3855,0
8600000US53820,53820,ZCTA5 53820,2532,0,0,0,2532,0
8600000US53821,53821,ZCTA5 53821,8456,6255,0,6255,2201,0
8600000US53825,53825,ZCTA5 53825,487,0,0,0,487,0
8600000US53826,53826,ZCTA5 53826,1332,0,0,0,1332,0
8600000US53827,53827,ZCTA5 53827,292,0,0,0,292,0
8600000US53901,53901,ZCTA5 53901,14445,10146,0,10146,4299,0
8600000US53910,53910,ZCTA5 53910,3508,0,0,0,3508,0
8600000US53911,53911,ZCTA5 53911,1351,0,0,0,1351,0
8600000US53913,53913,ZCTA5 53913,19881,14890,0,14890,4991,0
8600000US53916,53916,ZCTA5 53916,22507,17833,0,17833,4674,0
8600000US53919,53919,ZCTA5 53919,2629,0,0,0,2629,0
8600000US53920,53920,ZCTA5 53920,414,0,0,0,414,0
8600000US53922,53922,ZCTA5 53922,1036,0,0,0,1036,0
8600000US53923,53923,ZCTA5 53923,2098,0,0,0,2098,0
8600000US53924,53924,ZCTA5 53924,1360,0,0,0,1360,0
8600000US53925,53925,ZCTA5 53925,7781,4920,0,4920,2861,0
8600000US53926,53926,ZCTA5 53926,1628,0,0,0,1628,0
8600000US53928,53928,ZCTA5 53928,128,0,0,0,128,0
8600000US53929,53929,ZCTA5 53929,2782,0,0,0,2782,0
8600000US53930,53930,ZCTA5 53930,1285,0,0,0,1285,0
8600000US53931,53931,ZCTA5 53931,237,0,0,0,237,0
8600000US53932,53932,ZCTA5 53932,2573,1703,0,1703,870,0
8600000US53933,53933,ZCTA5 53933,4117,0,0,0,4117,0
8600000US53934,53934,ZCTA5 53934,4396,0,0,0,4396,0
8600000US53935,53935,ZCTA5 53935,307,0,0,0,307,0
8600000US53936,53936,ZCTA5 53936,1610,0,0,0,1610,0
8600000US53937,53937,ZCTA5 53937,1053,0,0,0,1053,0
8600000US53939,53939,ZCTA5 53939,244,0,0,0,244,0
8600000US53941,53941,ZCTA5 53941,2932,0,0,0,2932,0
8600000US53943,53943,ZCTA5 53943,1065,0,0,0,1065,0
8600000US53944,53944,ZCTA5 53944,2224,0,0,0,2224,0
8600000US53946,53946,ZCTA5 53946,4386,0,0,0,4386,0
8600000US53947,53947,ZCTA5 53947,137,0,0,0,137,0
8600000US53948,53948,ZCTA5 53948,8414,4401,0,4401,4013,0
8600000US53949,53949,ZCTA5 53949,6011,0,0,0,6011,0
8600000US53950,53950,ZCTA5 53950,5449,0,0,0,5449,0
8600000US53951,53951,ZCTA5 53951,2601,0,0,0,2601,0
8600000US53952,53952,ZCTA5 53952,4377,0,0,0,4377,0
8600000US53953,53953,ZCTA5 53953,282,0,0,0,282,0
8600000US53954,53954,ZCTA5 53954,6926,245,0,245,6681,0
8600000US53955,53955,ZCTA5 53955,5692,0,0,0,5692,0
8600000US53956,53956,ZCTA5 53956,3397,0,0,0,3397,0
8600000US53959,53959,ZCTA5 53959,13384,9190,0,9190,4194,0
8600000US53960,53960,ZCTA5 53960,3268,0,0,0,3268,0
8600000US53961,53961,ZCTA5 53961,837,0,0,0,837,0
8600000US53963,53963,ZCTA5 53963,13910,11373,0,11373,2537,0
8600000US53964,53964,ZCTA5 53964,3604,0,0,0,3604,0
8600000US53965,53965,ZCTA5 53965,10398,4342,0,4342,6056,0
8600000US53968,53968,ZCTA5 53968,2329,0,0,0,2329,0
8600000US53969,53969,ZCTA5 53969,419,0,0,0,419,0
8600000US54001,54001,ZCTA5 54001,8155,2832,0,2832,5323,0
8600000US54002,54002,ZCTA5 54002,6278,3977,0,3977,2301,0
8600000US54003,54003,ZCTA5 54003,1013,0,0,0,1013,0
8600000US54004,54004,ZCTA5 54004,2317,0,0,0,2317,0
8600000US54005,54005,ZCTA5 54005,3056,0,0,0,3056,0
8600000US54006,54006,ZCTA5 54006,743,0,0,0,743,0
8600000US54007,54007,ZCTA5 54007,1188,0,0,0,1188,0
8600000US54009,54009,ZCTA5 54009,2509,705,0,705,1804,0
8600000US54010,54010,ZCTA5 54010,50,50,0,50,0,0
8600000US54011,54011,ZCTA5 54011,6819,2773,0,2773,4046,0
8600000US54013,54013,ZCTA5 54013,3475,0,0,0,3475,0
8600000US54014,54014,ZCTA5 54014,2232,0,0,0,2232,0
8600000US54015,54015,ZCTA5 54015,3586,1854,0,1854,1732,0
8600000US54016,54016,ZCTA5 54016,30108,19201,0,19201,10907,0
8600000US54017,54017,ZCTA5 54017,16743,8275,0,8275,8468,0
8600000US54020,54020,ZCTA5 54020,7260,2888,0,2888,4372,0
8600000US54021,54021,ZCTA5 54021,6622,4152,0,4152,2470,0
8600000US54022,54022,ZCTA5 54022,22358,15351,0,15351,7007,0
8600000US54023,54023,ZCTA5 54023,3833,0,0,0,3833,0
8600000US54024,54024,ZCTA5 54024,4811,0,0,0,4811,0
8600000US54025,54025,ZCTA5 54025,6864,2604,0,2604,4260,0
8600000US54026,54026,ZCTA5 54026,1809,0,0,0,1809,0
8600000US54027,54027,ZCTA5 54027,989,0,0,0,989,0
8600000US54028,54028,ZCTA5 54028,2493,0,0,0,2493,0
8600000US54082,54082,ZCTA5 54082,1696,276,276,0,1420,0
8600000US54101,54101,ZCTA5 54101,2751,0,0,0,2751,0
8600000US54102,54102,ZCTA5 54102,875,0,0,0,875,0
8600000US54103,54103,ZCTA5 54103,418,0,0,0,418,0
8600000US54104,54104,ZCTA5 54104,1051,0,0,0,1051,0
8600000US54106,54106,ZCTA5 54106,4997,0,0,0,4997,0
8600000US54107,54107,ZCTA5 54107,3727,78,0,78,3649,0
8600000US54110,54110,ZCTA5 54110,5338,2968,0,2968,2370,0
8600000US54111,54111,ZCTA5 54111,2132,515,0,515,1617,0
8600000US54112,54112,ZCTA5 54112,2284,0,0,0,2284,0
8600000US54113,54113,ZCTA5 54113,3325,3325,3325,0,0,0
8600000US54114,54114,ZCTA5 54114,5178,0,0,0,5178,0
8600000US54115,54115,ZCTA5 54115,41178,31938,31938,0,9240,0
8600000US54119,54119,ZCTA5 54119,1083,0,0,0,1083,0
8600000US54120,54120,ZCTA5 54120,245,0,0,0,245,0
8600000US54121,54121,ZCTA5 54121,2982,0,0,0,2982,0
8600000US54123,54123,ZCTA5 54123,238,0,0,0,238,0
8600000US54124,54124,ZCTA5 54124,3881,0,0,0,3881,0
8600000US54125,54125,ZCTA5 54125,519,0,0,0,519,0
8600000US54126,54126,ZCTA5 54126,3625,0,0,0,3625,0
8600000US54127,54127,ZCTA5 54127,76,0,0,0,76,0
8600000US54128,54128,ZCTA5 54128,1778,0,0,0,1778,0
8600000US54129,54129,ZCTA5 54129,3477,0,0,0,3477,0
8600000US54130,54130,ZCTA5 54130,25108,16899,16899,0,8209,0
8600000US54135,54135,ZCTA5 54135,3096,0,0,0,3096,0
8600000US54136,54136,ZCTA5 54136,6406,6406,6406,0,0,0
8600000US54137,54137,ZCTA5 54137,1115,0,0,0,1115,0
8600000US54138,54138,ZCTA5 54138,821,0,0,0,821,0
8600000US54139,54139,ZCTA5 54139,3096,0,0,0,3096,0
8600000US54140,54140,ZCTA5 54140,8533,8533,8533,0,0,0
8600000US54141,54141,ZCTA5 54141,2549,132,132,0,2417,0
8600000US54143,54143,ZCTA5 54143,15225,10862,0,10862,4363,0
8600000US54149,54149,ZCTA5 54149,1184,0,0,0,1184,0
8600000US54150,54150,ZCTA5 54150,1037,0,0,0,1037,0
8600000US54151,54151,ZCTA5 54151,3556,1634,0,1634,1922,0
8600000US54153,54153,ZCTA5 54153,7252,4273,0,4273,2979,0
8600000US54154,54154,ZCTA5 54154,5548,2621,0,2621,2927,0
8600000US54155,54155,ZCTA5 54155,5451,1615,1615,0,3836,0
8600000US54156,54156,ZCTA5 54156,1535,0,0,0,1535,0
8600000US54157,54157,ZCTA5 54157,5986,3440,0,3440,2546,0
8600000US54159,54159,ZCTA5 54159,1434,0,0,0,1434,0
8600000US54160,54160,ZCTA5 54160,253,0,0,0,253,0
8600000US54161,54161,ZCTA5 54161,2696,0,0,0,2696,0
8600000US54162,54162,ZCTA5 54162,9065,3363,0,3363,5702,0
8600000US54165,54165,ZCTA5 54165,7539,3500,0,3500,4039,0
8600000US54166,54166,ZCTA5 54166,17002,9934,0,9934,7068,0
8600000US54169,54169,ZCTA5 54169,2600,2475,2475,0,125,0
8600000US54170,54170,ZCTA5 54170,3730,0,0,0,3730,0
8600000US54171,54171,ZCTA5 54171,3362,0,0,0,3362,0
8600000US54173,54173,ZCTA5 54173,4095,2358,2358,0,1737,0
8600000US54174,54174,ZCTA5 54174,3013,0,0,0,3013,0
8600000US54175,54175,ZCTA5 54175,1018,0,0,0,1018,0
8600000US54177,54177,ZCTA5 54177,2898,0,0,0,2898,0
8600000US54180,54180,ZCTA5 54180,2861,2524,0,2524,337,0
8600000US54201,54201,ZCTA5 54201,5345,3070,0,3070,2275,0
8600000US54202,54202,ZCTA5 54202,1240,0,0,0,1240,0
8600000US54204,54204,ZCTA5 54204,1819,0,0,0,1819,0
8600000US54205,54205,ZCTA5 54205,2177,0,0,0,2177,0
8600000US54207,54207,ZCTA5 54207,176,0,0,0,176,0
8600000US54208,54208,ZCTA5 54208,6061,0,0,0,6061,0
8600000US54209,54209,ZCTA5 54209,1195,0,0,0,1195,0
8600000US54210,54210,ZCTA5 54210,897,0,0,0,897,0
8600000US54211,54211,ZCTA5 54211,277,0,0,0,277,0
8600000US54212,54212,ZCTA5 54212,997,0,0,0,997,0
8600000US54213,54213,ZCTA5 54213,1276,0,0,0,1276,0
8600000US54214,54214,ZCTA5 54214,334,0,0,0,334,0
8600000US54216,54216,ZCTA5 54216,6276,2622,0,2622,3654,0
8600000US54217,54217,ZCTA5 54217,7405,0,0,0,7405,0
8600000US54220,54220,ZCTA5 54220,40220,34405,0,34405,5815,0
8600000US54227,54227,ZCTA5 54227,1568,0,0,0,1568,0
8600000US54228,54228,ZCTA5 54228,2682,0,0,0,2682,0
8600000US54229,54229,ZCTA5 54229,4306,912,912,0,3394,0
8600000US54230,54230,ZCTA5 54230,4782,0,0,0,4782,0
8600000US54232,54232,ZCTA5 54232,779,0,0,0,779,0
8600000US54234,54234,ZCTA5 54234,1614,0,0,0,1614,0
8600000US54235,54235,ZCTA5 54235,17203,8617,0,8617,8586,0
8600000US54241,54241,ZCTA5 54241,14884,11955,0,11955,2929,0
8600000US54245,54245,ZCTA5 54245,2259,0,0,0,2259,0
8600000US54246,54246,ZCTA5 54246,708,0,0,0,708,0
8600000US54247,54247,ZCTA5 54247,2339,0,0,0,2339,0
8600000US54301,54301,ZCTA5 54301,22742,22742,22742,0,0,0
8600000US54302,54302,ZCTA5 54302,30611,30611,30611,0,0,0
8600000US54303,54303,ZCTA5 54303,27041,26995,26995,0,46,0
8600000US54304,54304,ZCTA5 54304,28153,28153,28153,0,0,0
8600000US54307,54307,ZCTA5 54307,1092,1092,1092,0,0,0
8600000US54311,54311,ZCTA5 54311,33580,29491,29491,0,4089,0
8600000US54313,54313,ZCTA5 54313,35897,30481,30481,0,5416,0
8600000US54401,54401,ZCTA5 54401,30702,24926,24926,0,5776,0
8600000US54403,54403,ZCTA5 54403,24272,19155,19155,0,5117,0
8600000US54405,54405,ZCTA5 54405,3032,2138,0,2138,894,0
8600000US54406,54406,ZCTA5 54406,3469,0,0,0,3469,0
8600000US54407,54407,ZCTA5 54407,1515,0,0,0,1515,0
8600000US54408,54408,ZCTA5 54408,1068,0,0,0,1068,0
8600000US54409,54409,ZCTA5 54409,13238,8158,0,8158,5080,0
8600000US54410,54410,ZCTA5 54410,2392,0,0,0,2392,0
8600000US54411,54411,ZCTA5 54411,5406,0,0,0,5406,0
8600000US54412,54412,ZCTA5 54412,2181,0,0,0,2181,0
8600000US54413,54413,ZCTA5 54413,191,0,0,0,191,0
8600000US54414,54414,ZCTA5 54414,3404,0,0,0,3404,0
8600000US54416,54416,ZCTA5 54416,1684,0,0,0,1684,0
8600000US54417,54417,ZCTA5 54417,46,0,0,0,46,0
8600000US54418,54418,ZCTA5 54418,1080,0,0,0,1080,0
8600000US54420,54420,ZCTA5 54420,1307,0,0,0,1307,0
8600000US54421,54421,ZCTA5 54421,3455,1828,0,1828,1627,0
8600000US54422,54422,ZCTA5 54422,1209,0,0,0,1209,0
8600000US54423,54423,ZCTA5 54423,2343,0,0,0,2343,0
8600000US54424,54424,ZCTA5 54424,1651,0,0,0,1651,0
8600000US54425,54425,ZCTA5 54425,2036,0,0,0,2036,0
8600000US54426,54426,ZCTA5 54426,4479,0,0,0,4479,0
8600000US54427,54427,ZCTA5 54427,1099,0,0,0,1099,0
8600000US54428,54428,ZCTA5 54428,1127,0,0,0,1127,0
8600000US54430,54430,ZCTA5 54430,135,0,0,0,135,0
8600000US54433,54433,ZCTA5 54433,1845,0,0,0,1845,0
8600000US54435,54435,ZCTA5 54435,2010,0,0,0,2010,0
8600000US54436,54436,ZCTA5 54436,2203,0,0,0,2203,0
8600000US54437,54437,ZCTA5 54437,3077,0,0,0,3077,0
8600000US54440,54440,ZCTA5 54440,2964,0,0,0,2964,0
8600000US54441,54441,ZCTA5 54441,828,562,0,562,266,0
8600000US54442,54442,ZCTA5 54442,1177,0,0,0,1177,0
8600000US54443,54443,ZCTA5 54443,2137,0,0,0,2137,0
8600000US54446,54446,ZCTA5 54446,3123,0,0,0,3123,0
8600000US54447,54447,ZCTA5 54447,498,0,0,0,498,0
8600000US54448,54448,ZCTA5 54448,4249,0,0,0,4249,0
8600000US54449,54449,ZCTA5 54449,26418,18859,0,18859,7559,0
8600000US54450,54450,ZCTA5 54450,436,0,0,0,436,0
8600000US54451,54451,ZCTA5 54451,11755,4046,0,4046,7709,0
8600000US54452,54452,ZCTA5 54452,19360,10282,0,10282,9078,0
8600000US54454,54454,ZCTA5 54454,1279,0,0,0,1279,0
8600000US54455,54455,ZCTA5 54455,17029,9327,9327,0,7702,0
8600000US54456,54456,ZCTA5 54456,6085,0,0,0,6085,0
8600000US54457,54457,ZCTA5 54457,8539,2253,0,2253,6286,0
8600000US54458,54458,ZCTA5 54458,124,0,0,0,124,0
8600000US54459,54459,ZCTA5 54459,1148,0,0,0,1148,0
8600000US54460,54460,ZCTA5 54460,2746,0,0,0,2746,0
8600000US54462,54462,ZCTA5 54462,348,0,0,0,348,0
8600000US54463,54463,ZCTA5 54463,684,0,0,0,684,0
8600000US54465,54465,ZCTA5 54465,536,0,0,0,536,0
8600000US54466,54466,ZCTA5 54466,2815,0,0,0,2815,0
8600000US54467,54467,ZCTA5 54467,13635,11862,0,11862,1773,0
8600000US54469,54469,ZCTA5 54469,1792,1726,0,1726,66,0
8600000US54470,54470,ZCTA5 54470,2068,0,0,0,2068,0
8600000US54471,54471,ZCTA5 54471,1854,44,44,0,1810,0
8600000US54473,54473,ZCTA5 54473,2700,0,0,0,2700,0
8600000US54474,54474,ZCTA5 54474,4019,4019,4019,0,0,0
8600000US54475,54475,ZCTA5 54475,1482,0,0,0,1482,0
8600000US54476,54476,ZCTA5 54476,18580,17161,17161,0,1419,0
8600000US54479,54479,ZCTA5 54479,4119,0,0,0,4119,0
8600000US54480,54480,ZCTA5 54480,1332,0,0,0,1332,0
8600000US54481,54481,ZCTA5 54481,29340,27382,0,27382,1958,0
8600000US54482,54482,ZCTA5 54482,8955,4979,0,4979,3976,0
8600000US54484,54484,ZCTA5 54484,4984,0,0,0,4984,0
8600000US54485,54485,ZCTA5 54485,322,0,0,0,322,0
8600000US54486,54486,ZCTA5 54486,2290,0,0,0,2290,0
8600000US54487,54487,ZCTA5 54487,9594,2926,0,2926,6668,0
8600000US54488,54488,ZCTA5 54488,1262,0,0,0,1262,0
8600000US54489,54489,ZCTA5 54489,1550,0,0,0,1550,0
8600000US54490,54490,ZCTA5 54490,893,0,0,0,893,0
8600000US54491,54491,ZCTA5 54491,1652,0,0,0,1652,0
8600000US54493,54493,ZCTA5 54493,668,0,0,0,668,0
8600000US54494,54494,ZCTA5 54494,27126,20149,0,20149,6977,0
8600000US54495,54495,ZCTA5 54495,7637,5041,0,5041,2596,0
8600000US54498,54498,ZCTA5 54498,2421,0,0,0,2421,0
8600000US54499,54499,ZCTA5 54499,3223,0,0,0,3223,0
8600000US54501,54501,ZCTA5 54501,20019,9010,0,9010,11009,0
8600000US54511,54511,ZCTA5 54511,1216,0,0,0,1216,0
8600000US54512,54512,ZCTA5 54512,833,0,0,0,833,0
8600000US54513,54513,ZCTA5 54513,478,0,0,0,478,0
8600000US54514,54514,ZCTA5 54514,1717,0,0,0,1717,0
8600000US54515,54515,ZCTA5 54515,472,0,0,0,472,0
8600000US54517,54517,ZCTA5 54517,112,0,0,0,112,0
8600000US54519,54519,ZCTA5 54519,1231,0,0,0,1231,0
8600000US54520,54520,ZCTA5 54520,4141,0,0,0,4141,0
8600000US54521,54521,ZCTA5 54521,7509,0,0,0,7509,0
8600000US54524,54524,ZCTA5 54524,670,0,0,0,670,0
8600000US54525,54525,ZCTA5 54525,279,226,0,226,53,0
8600000US54526,54526,ZCTA5 54526,919,0,0,0,919,0
8600000US54527,54527,ZCTA5 54527,1081,0,0,0,1081,0
8600000US54529,54529,ZCTA5 54529,1133,0,0,0,1133,0
8600000US54530,54530,ZCTA5 54530,868,0,0,0,868,0
8600000US54531,54531,ZCTA5 54531,1454,0,0,0,1454,0
8600000US54534,54534,ZCTA5 54534,2459,1281,0,1281,1178,0
8600000US54536,54536,ZCTA5 54536,184,0,0,0,184,0
8600000US54537,54537,ZCTA5 54537,561,0,0,0,561,0
8600000US54538,54538,ZCTA5 54538,3137,0,0,0,3137,0
8600000US54539,54539,ZCTA5 54539,1383,0,0,0,1383,0
8600000US54540,54540,ZCTA5 54540,947,0,0,0,947,0
8600000US54541,54541,ZCTA5 54541,1552,0,0,0,1552,0
8600000US54542,54542,ZCTA5 54542,470,0,0,0,470,0
8600000US54545,54545,ZCTA5 54545,736,0,0,0,736,0
8600000US54546,54546,ZCTA5 54546,1266,0,0,0,1266,0
8600000US54547,54547,ZCTA5 54547,1392,0,0,0,1392,0
8600000US54548,54548,ZCTA5 54548,4626,0,0,0,4626,0
8600000US54550,54550,ZCTA5 54550,685,398,0,398,287,0
8600000US54552,54552,ZCTA5 54552,4416,0,0,0,4416,0
8600000US54554,54554,ZCTA5 54554,1120,0,0,0,1120,0
8600000US54555,54555,ZCTA5 54555,4872,0,0,0,4872,0
8600000US54556,54556,ZCTA5 54556,1298,0,0,0,1298,0
8600000US54557,54557,ZCTA5 54557,925,0,0,0,925,0
8600000US54558,54558,ZCTA5 54558,2177,0,0,0,2177,0
8600000US54559,54559,ZCTA5 54559,795,0,0,0,795,0
8600000US54560,54560,ZCTA5 54560,589,0,0,0,589,0
8600000US54561,54561,ZCTA5 54561,35,0,0,0,35,0
8600000US54562,54562,ZCTA5 54562,1948,0,0,0,1948,0
8600000US54563,54563,ZCTA5 54563,720,0,0,0,720,0
8600000US54564,54564,ZCTA5 54564,387,0,0,0,387,0
8600000US54565,54565,ZCTA5 54565,60,0,0,0,60,0
8600000US54566,54566,ZCTA5 54566,1496,0,0,0,1496,0
8600000US54568,54568,ZCTA5 54568,5198,0,0,0,5198,0
8600000US54601,54601,ZCTA5 54601,49282,44274,44274,0,5008,0
8600000US54603,54603,ZCTA5 54603,14305,14305,14305,0,0,0
8600000US54610,54610,ZCTA5 54610,1624,0,0,0,1624,0
8600000US54611,54611,ZCTA5 54611,1307,0,0,0,1307,0
8600000US54612,54612,ZCTA5 54612,5152,2993,0,2993,2159,0
8600000US54613,54613,ZCTA5 54613,1826,0,0,0,1826,0
8600000US54614,54614,ZCTA5 54614,2947,0,0,0,2947,0
8600000US54615,54615,ZCTA5 54615,10742,5677,0,5677,5065,0
8600000US54616,54616,ZCTA5 54616,2601,0,0,0,2601,0
8600000US54618,54618,ZCTA5 54618,2262,0,0,0,2262,0
8600000US54619,54619,ZCTA5 54619,3923,0,0,0,3923,0
8600000US54621,54621,ZCTA5 54621,1147,0,0,0,1147,0
8600000US54622,54622,ZCTA5 54622,2121,0,0,0,2121,0
8600000US54623,54623,ZCTA5 54623,1930,0,0,0,1930,0
8600000US54624,54624,ZCTA5 54624,1383,0,0,0,1383,0
8600000US54625,54625,ZCTA5 54625,240,0,0,0,240,0
8600000US54626,54626,ZCTA5 54626,1215,0,0,0,1215,0
8600000US54627,54627,ZCTA5 54627,1819,0,0,0,1819,0
8600000US54628,54628,ZCTA5 54628,1092,0,0,0,1092,0
8600000US54629,54629,ZCTA5 54629,2576,0,0,0,2576,0
8600000US54630,54630,ZCTA5 54630,3770,0,0,0,3770,0
8600000US54631,54631,ZCTA5 54631,1844,0,0,0,1844,0
8600000US54632,54632,ZCTA5 54632,1247,0,0,0,1247,0
8600000US54634,54634,ZCTA5 54634,4258,0,0,0,4258,0
8600000US54635,54635,ZCTA5 54635,1799,0,0,0,1799,0
8600000US54636,54636,ZCTA5 54636,13737,9918,9918,0,3819,0
8600000US54637,54637,ZCTA5 54637,187,0,0,0,187,0
8600000US54638,54638,ZCTA5 54638,1487,0,0,0,1487,0
8600000US54639,54639,ZCTA5 54639,2397,0,0,0,2397,0
8600000US54641,54641,ZCTA5 54641,2,0,0,0,2,0
8600000US54642,54642,ZCTA5 54642,2125,0,0,0,2125,0
8600000US54643,54643,ZCTA5 54643,12,0,0,0,12,0
8600000US54644,54644,ZCTA5 54644,1434,0,0,0,1434,0
8600000US54645,54645,ZCTA5 54645,81,0,0,0,81,0
8600000US54646,54646,ZCTA5 54646,3899,0,0,0,3899,0
8600000US54648,54648,ZCTA5 54648,1737,0,0,0,1737,0
8600000US54650,54650,ZCTA5 54650,23377,21471,21471,0,1906,0
8600000US54651,54651,ZCTA5 54651,1382,0,0,0,1382,0
8600000US54652,54652,ZCTA5 54652,953,0,0,0,953,0
8600000US54653,54653,ZCTA5 54653,894,0,0,0,894,0
8600000US54654,54654,ZCTA5 54654,153,0,0,0,153,0
8600000US54655,54655,ZCTA5 54655,1778,0,0,0,1778,0
8600000US54656,54656,ZCTA5 54656,17377,9907,0,9907,7470,0
8600000US54657,54657,ZCTA5 54657,411,0,0,0,411,0
8600000US54658,54658,ZCTA5 54658,2501,233,233,0,2268,0
8600000US54659,54659,ZCTA5 54659,1409,0,0,0,1409,0
8600000US54660,54660,ZCTA5 54660,15688,9002,0,9002,6686,0
8600000US54661,54661,ZCTA5 54661,3415,0,0,0,3415,0
8600000US54664,54664,ZCTA5 54664,1516,0,0,0,1516,0
8600000US54665,54665,ZCTA5 54665,8427,4097,0,4097,4330,0
8600000US54666,54666,ZCTA5 54666,2593,0,0,0,2593,0
8600000US54667,54667,ZCTA5 54667,4599,0,0,0,4599,0
8600000US54669,54669,ZCTA5 54669,7619,5309,5309,0,2310,0
8600000US54670,54670,ZCTA5 54670,1878,0,0,0,1878,0
8600000US54701,54701,ZCTA5 54701,38803,33205,33205,0,5598,0
8600000US54703,54703,ZCTA5 54703,42272,38138,38138,0,4134,0
8600000US54720,54720,ZCTA5 54720,7039,7037,7037,0,2,0
8600000US54721,54721,ZCTA5 54721,1373,0,0,0,1373,0
8600000US54722,54722,ZCTA5 54722,4016,0,0,0,4016,0
8600000US54723,54723,ZCTA5 54723,1191,0,0,0,1191,0
8600000US54724,54724,ZCTA5 54724,7174,3348,0,3348,3826,0
8600000US54725,54725,ZCTA5 54725,2897,0,0,0,2897,0
8600000US54726,54726,ZCTA5 54726,1690,0,0,0,1690,0
8600000US54727,54727,ZCTA5 54727,4915,79,79,0,4836,0
8600000US54728,54728,ZCTA5 54728,6139,2700,0,2700,3439,0
8600000US54729,54729,ZCTA5 54729,31469,24393,24393,0,7076,0
8600000US54730,54730,ZCTA5 54730,4903,401,0,401,4502,0
8600000US54731,54731,ZCTA5 54731,802,0,0,0,802,0
8600000US54732,54732,ZCTA5 54732,2924,0,0,0,2924,0
8600000US54733,54733,ZCTA5 54733,1340,0,0,0,1340,0
8600000US54734,54734,ZCTA5 54734,856,0,0,0,856,0
8600000US54736,54736,ZCTA5 54736,4127,0,0,0,4127,0
8600000US54737,54737,ZCTA5 54737,487,0,0,0,487,0
8600000US54738,54738,ZCTA5 54738,3149,0,0,0,3149,0
8600000US54739,54739,ZCTA5 54739,4950,0,0,0,4950,0
8600000US54740,54740,ZCTA5 54740,2056,0,0,0,2056,0
8600000US54741,54741,ZCTA5 54741,1577,0,0,0,1577,0
8600000US54742,54742,ZCTA5 54742,4459,0,0,0,4459,0
8600000US54745,54745,ZCTA5 54745,2261,0,0,0,2261,0
8600000US54746,54746,ZCTA5 54746,746,0,0,0,746,0
8600000US54747,54747,ZCTA5 54747,2534,0,0,0,2534,0
8600000US54748,54748,ZCTA5 54748,1217,0,0,0,1217,0
8600000US54749,54749,ZCTA5 54749,1231,0,0,0,1231,0
8600000US54750,54750,ZCTA5 54750,1062,0,0,0,1062,0
8600000US54751,54751,ZCTA5 54751,25642,17443,0,17443,8199,0
8600000US54754,54754,ZCTA5 54754,1552,0,0,0,1552,0
8600000US54755,54755,ZCTA5 54755,7502,0,0,0,7502,0
8600000US54756,54756,ZCTA5 54756,916,0,0,0,916,0
8600000US54757,54757,ZCTA5 54757,3314,0,0,0,3314,0
8600000US54758,54758,ZCTA5 54758,4626,0,0,0,4626,0
8600000US54759,54759,ZCTA5 54759,1533,0,0,0,1533,0
8600000US54760,54760,ZCTA5 54760,255,0,0,0,255,0
8600000US54761,54761,ZCTA5 54761,1216,0,0,0,1216,0
8600000US54762,54762,ZCTA5 54762,1246,0,0,0,1246,0
8600000US54763,54763,ZCTA5 54763,1134,0,0,0,1134,0
8600000US54765,54765,ZCTA5 54765,24,0,0,0,24,0
8600000US54766,54766,ZCTA5 54766,1707,0,0,0,1707,0
8600000US54767,54767,ZCTA5 54767,3221,0,0,0,3221,0
8600000US54768,54768,ZCTA5 54768,5990,3447,0,3447,2543,0
8600000US54769,54769,ZCTA5 54769,502,0,0,0,502,0
8600000US54770,54770,ZCTA5 54770,2101,0,0,0,2101,0
8600000US54771,54771,ZCTA5 54771,4286,0,0,0,4286,0
8600000US54772,54772,ZCTA5 54772,1103,0,0,0,1103,0
8600000US54773,54773,ZCTA5 54773,3336,0,0,0,3336,0
8600000US54801,54801,ZCTA5 54801,6493,2673,0,2673,3820,0
8600000US54805,54805,ZCTA5 54805,1471,0,0,0,1471,0
8600000US54806,54806,ZCTA5 54806,11810,7293,0,7293,4517,0
8600000US54810,54810,ZCTA5 54810,2512,0,0,0,2512,0
8600000US54812,54812,ZCTA5 54812,5728,3292,0,3292,2436,0
8600000US54813,54813,ZCTA5 54813,601,0,0,0,601,0
8600000US54814,54814,ZCTA5 54814,2478,0,0,0,2478,0
8600000US54817,54817,ZCTA5 54817,2188,0,0,0,2188,0
8600000US54819,54819,ZCTA5 54819,2544,0,0,0,2544,0
8600000US54820,54820,ZCTA5 54820,864,0,0,0,864,0
8600000US54821,54821,ZCTA5 54821,1276,0,0,0,1276,0
8600000US54822,54822,ZCTA5 54822,4516,137,0,137,4379,0
8600000US54824,54824,ZCTA5 54824,2271,0,0,0,2271,0
8600000US54826,54826,ZCTA5 54826,807,0,0,0,807,0
8600000US54827,54827,ZCTA5 54827,221,0,0,0,221,0
8600000US54828,54828,ZCTA5 54828,678,0,0,0,678,0
8600000US54829,54829,ZCTA5 54829,5236,0,0,0,5236,0
8600000US54830,54830,ZCTA5 54830,2752,0,0,0,2752,0
8600000US54832,54832,ZCTA5 54832,412,0,0,0,412,0
8600000US54835,54835,ZCTA5 54835,1018,0,0,0,1018,0
8600000US54836,54836,ZCTA5 54836,1080,0,0,0,1080,0
8600000US54837,54837,ZCTA5 54837,3778,0,0,0,3778,0
8600000US54838,54838,ZCTA5 54838,1103,0,0,0,1103,0
8600000US54839,54839,ZCTA5 54839,302,0,0,0,302,0
8600000US54840,54840,ZCTA5 54840,4643,0,0,0,4643,0
8600000US54841,54841,ZCTA5 54841,259,0,0,0,259,0
8600000US54842,54842,ZCTA5 54842,185,0,0,0,185,0
8600000US54843,54843,ZCTA5 54843,11487,2616,0,2616,8871,0
8600000US54844,54844,ZCTA5 54844,267,0,0,0,267,0
8600000US54845,54845,ZCTA5 54845,147,0,0,0,147,0
8600000US54846,54846,ZCTA5 54846,547,0,0,0,547,0
8600000US54847,54847,ZCTA5 54847,2222,0,0,0,2222,0
8600000US54848,54848,ZCTA5 54848,6141,3449,0,3449,2692,0
8600000US54849,54849,ZCTA5 54849,1967,0,0,0,1967,0
8600000US54850,54850,ZCTA5 54850,261,0,0,0,261,0
8600000US54853,54853,ZCTA5 54853,4009,0,0,0,4009,0
8600000US54854,54854,ZCTA5 54854,990,0,0,0,990,0
8600000US54855,54855,ZCTA5 54855,774,0,0,0,774,0
8600000US54856,54856,ZCTA5 54856,1616,0,0,0,1616,0
8600000US54857,54857,ZCTA5 54857,62,0,0,0,62,0
8600000US54858,54858,ZCTA5 54858,1518,0,0,0,1518,0
8600000US54859,54859,ZCTA5 54859,1896,0,0,0,1896,0
8600000US54861,54861,ZCTA5 54861,150,0,0,0,150,0
8600000US54862,54862,ZCTA5 54862,261,0,0,0,261,0
8600000US54864,54864,ZCTA5 54864,1322,0,0,0,1322,0
8600000US54865,54865,ZCTA5 54865,440,0,0,0,440,0
8600000US54867,54867,ZCTA5 54867,435,0,0,0,435,0
8600000US54868,54868,ZCTA5 54868,15512,9500,0,9500,6012,0
8600000US54870,54870,ZCTA5 54870,1486,0,0,0,1486,0
8600000US54871,54871,ZCTA5 54871,3105,0,0,0,3105,0
8600000US54872,54872,ZCTA5 54872,2581,0,0,0,2581,0
8600000US54873,54873,ZCTA5 54873,2799,0,0,0,2799,0
8600000US54874,54874,ZCTA5 54874,3646,142,142,0,3504,0
8600000US54875,54875,ZCTA5 54875,1055,0,0,0,1055,0
8600000US54876,54876,ZCTA5 54876,1551,0,0,0,1551,0
8600000US54880,54880,ZCTA5 54880,30772,26903,26903,0,3869,0
8600000US54888,54888,ZCTA5 54888,1345,0,0,0,1345,0
8600000US54889,54889,ZCTA5 54889,2742,0,0,0,2742,0
8600000US54891,54891,ZCTA5 54891,3389,0,0,0,3389,0
8600000US54893,54893,ZCTA5 54893,3767,0,0,0,3767,0
8600000US54895,54895,ZCTA5 54895,910,0,0,0,910,0
8600000US54896,54896,ZCTA5 54896,1478,0,0,0,1478,0
8600000US54901,54901,ZCTA5 54901,37710,37274,37274,0,436,0
8600000US54902,54902,ZCTA5 54902,22375,20454,20454,0,1921,0
8600000US54904,54904,ZCTA5 54904,20623,16388,16263,125,4235,0
8600000US54909,54909,ZCTA5 54909,2181,0,0,0,2181,0
8600000US54911,54911,ZCTA5 54911,26674,26674,26674,0,0,0
8600000US54913,54913,ZCTA5 54913,17629,10880,10880,0,6749,0
8600000US54914,54914,ZCTA5 54914,30475,30200,30200,0,275,0
8600000US54915,54915,ZCTA5 54915,41855,41772,41772,0,83,0
8600000US54921,54921,ZCTA5 54921,1326,0,0,0,1326,0
8600000US54922,54922,ZCTA5 54922,1514,0,0,0,1514,0
8600000US54923,54923,ZCTA5 54923,8733,4891,0,4891,3842,0
8600000US54927,54927,ZCTA5 54927,538,538,0,538,0,0
8600000US54928,54928,ZCTA5 54928,450,0,0,0,450,0
8600000US54929,54929,ZCTA5 54929,8746,4481,0,4481,4265,0
8600000US54930,54930,ZCTA5 54930,1786,0,0,0,1786,0
8600000US54931,54931,ZCTA5 54931,260,0,0,0,260,0
8600000US54932,54932,ZCTA5 54932,1185,0,0,0,1185,0
8600000US54933,54933,ZCTA5 54933,231,0,0,0,231,0
8600000US54934,54934,ZCTA5 54934,148,0,0,0,148,0
8600000US54935,54935,ZCTA5 54935,41651,41450,41450,0,201,0
8600000US54937,54937,ZCTA5 54937,19112,11805,11805,0,7307,0
8600000US54940,54940,ZCTA5 54940,4020,0,0,0,4020,0
8600000US54941,54941,ZCTA5 54941,2613,0,0,0,2613,0
8600000US54942,54942,ZCTA5 54942,8580,6419,6419,0,2161,0
8600000US54943,54943,ZCTA5 54943,1923,0,0,0,1923,0
8600000US54944,54944,ZCTA5 54944,8257,98,98,0,8159,0
8600000US54945,54945,ZCTA5 54945,3545,0,0,0,3545,0
8600000US54946,54946,ZCTA5 54946,108,108,0,108,0,0
8600000US54947,54947,ZCTA5 54947,2601,0,0,0,2601,0
8600000US54948,54948,ZCTA5 54948,320,0,0,0,320,0
8600000US54949,54949,ZCTA5 54949,3430,0,0,0,3430,0
8600000US54950,54950,ZCTA5 54950,3083,0,0,0,3083,0
8600000US54952,54952,ZCTA5 54952,25729,24940,24940,0,789,0
8600000US54956,54956,ZCTA5 54956,42696,37533,37533,0,5163,0
8600000US54960,54960,ZCTA5 54960,2800,0,0,0,2800,0
8600000US54961,54961,ZCTA5 54961,14266,7643,0,7643,6623,0
8600000US54962,54962,ZCTA5 54962,1110,0,0,0,1110,0
8600000US54963,54963,ZCTA5 54963,6917,3358,0,3358,3559,0
8600000US54964,54964,ZCTA5 54964,1022,0,0,0,1022,0
8600000US54965,54965,ZCTA5 54965,1344,0,0,0,1344,0
8600000US54966,54966,ZCTA5 54966,2008,0,0,0,2008,0
8600000US54967,54967,ZCTA5 54967,434,0,0,0,434,0
8600000US54968,54968,ZCTA5 54968,2779,0,0,0,2779,0
8600000US54970,54970,ZCTA5 54970,3902,0,0,0,3902,0
8600000US54971,54971,ZCTA5 54971,10827,7930,0,7930,2897,0
8600000US54974,54974,ZCTA5 54974,1581,0,0,0,1581,0
8600000US54977,54977,ZCTA5 54977,1337,0,0,0,1337,0
8600000US54979,54979,ZCTA5 54979,1472,117,117,0,1355,0
8600000US54980,54980,ZCTA5 54980,149,0,0,0,149,0
8600000US54981,54981,ZCTA5 54981,15426,7647,0,7647,7779,0
8600000US54982,54982,ZCTA5 54982,7117,2573,0,2573,4544,0
8600000US54983,54983,ZCTA5 54983,4642,0,0,0,4642,0
8600000US54984,54984,ZCTA5 54984,2989,0,0,0,2989,0
8600000US54985,54985,ZCTA5 54985,836,836,836,0,0,0
8600000US54986,54986,ZCTA5 54986,4770,2991,0,2991,1779,0
